SSSSSSSSSSSSSSSSSSSSSSSSSSSSSSSSSSSSSSSS
SMMMMMM MMDMBMMMMMMBMBMMMMMMM MMMMBMMMMS
SMBRBMMMMMM MMMMMMMMMBDMMBMMMM MMMMM MMS
SMMMMMMMMMM MM MMMMMBMBMMBMMMMMMMMBMMMMS
SBM  MMMMMMMMMBMMMMMMBMMBMMMMBMMMBMMMMMS
SBMBBMMMMMMMMMBBMMBMMMMMMMMBMMMMMMBMB MS
SMMMBMMBMMMMMMMMBMMMMMBM BMMMMMMMMBMBBMS
SWWWWWWWWWWWWWWWWWWWWWWWWWWWWWWMMMBMMBMS
SM MMMBMMDM MMBMBMMMMMMMMMMDMB MMMMMMBMS
SMMDMMMMMBMMMMM MMMMMMMMB  BMMDMMMMBMMMS
SMMMBMMBMBMMMMMMMMMMMMMMBBMBMMBMMMMMMMMS
SM MMMMMBMMMMMMMMBB MMMMMMMBMMBMDMMMM MS
SMBMM MMBMMMMMMMMBMBDMMDMMMMBMMMBMMDMBMS
SMDBMMMMMMMMMMMMMMBBBMMBMMMMMMMMDMMMMMBS
SMMMMMMMMWWWWWWWWWWWWWWWWWWWWWWWWWWWWWWS
S  MMMMMMMMM MMMDMMMMBMMMMMBMMMBMMMMMMMS
SB MMMMMMMMMBBMMBMMMMMMMMBMMMMMMBMB MMES
SMBMMBMMMMMMMMBMMMMMBM  MMMMDMMMBMBBMMMS
SMMMMBDMM MMMMMMMMBMMMMMMBMBDMMMMMMBMMMS
SMMM MM MBMMBMBBMMMMMMMMMBMBDMMMMMMBMMBS
SMDMMMMBMMMMM MMMMMMMMM MBMMBMMMMBMMMBMS
SSSSSSSSSSSSSSSSSSSSSSSSSSSSSSSSSSSSSSSS
