SSSSSSSSSSSSSSSSSSSSSSSSSSSSSSSSSSSSSSSS
SMBMMBMMWMBMMMDMWMMM MBMW MMMMMMWMMBBMMS
SMMMMMMMWMMMMMM W  M MMMW MM MMMWMMMM MS
S              B BB      B  D        B S
SDMMMMMMWMBMMMMBWMBM MM WMMBMMDMWMMBMBMS
SMMMMMMMWMBMMMMBWMBM  MMWMMMMMBMWMMM MMS
SWWWWWWWWWWWWWWWWWWB WWWWWWWWWWWWWWWWWWS
SMMMMBBMWMM MMMMWMMM MMBWMMMM MMWMMMMM S
SMMMMMMMWMM MMMMWMMB MMMWMMMMBM WMMMMMBS
S          B                 B        BS
SBMMBMMMWMMMMBMMWMMB MMMWMMMMMMDW MMMMMS
SBMMMMBMWMMBMMBMWMMM M  WMMMMMMMWBMMMBMS
SMBMMMMMWMMMBMMMWMMM MBBWMMMMMMMWBBMMBMS
SWWWWWWWWWWWWWWWWWWW WWWWWWWWWWWWWWWWWWS
SBM F MMWMMMMBMBWMMM MMMWMBDMMBMWMMMMMMS
SMMMMM MW MMMMMMWMM  MMMW MM MMMWM M  MS
S        B         D        B     B BB S
SDMM MBMWBMMMMBMWMBM MMBWMBMBMMMWMMMMMMS
SMMMMMBMWBMMDMMMWMMM  MMWMMBMMMMWMMM   S
SMDMMMB WMM MMMMWMRDBBMMWM MMMMMWMMMBBBS
SMBMMMMBWMMBMMBMWMEMBMMMWMMMMBMBWMMMMBMS
SSSSSSSSSSSSSSSSSSSSSSSSSSSSSSSSSSSSSSSS
