SSSSSSSSSSSSSSSSSSSSSSSSSSSSSSSSSSSSSSSS
S                                      S
S                                      S
S                                      S
S                                      S
S                                      S
S                                      S
S                DDD  RE               S
S                WWWWWW                S
S                                      S
S                                      S
S                                      S
S                                      S
S                                      S
S                                      S
S                                      S
S                                      S
S                                      S
S                                      S
SSSSSSSSSSSSSSSSSSSSSSSSSSSSSSSSSSSSSSSS